1111111111111111111
10000000C0000000001
1001011111000001101
10010000C0000P01101
10010000000X0E01101
10001111101100000C1
1111111111111111111